NO ./textures/north.png
SO ./textures/south.png
WE ./textures/east.png
EA ./textures/west.png
	 
	
C                255,33,22
F 255,0,123

11111111111111111
1000000N0000000001
110111111111111111
 10101
 111111
