NO ./textures/north.png
SO ./textures/south.png
WE ./textures/east.png
EA ./textures/west.png
	 
	
C                255,33,22
F 255,0,123






111111D111111111111111111111111111111111111
1000000000000000000000000000000000000000001
100D000000000000000000000000000000000000001
100000000000W000000000000000000000000000001
1000000000000000000000000000000000000000001
1000000000000000000000000000000000000000001
1111111111111111111111111111111111111111111 
