WE textures/west.png
EA textures/east.png
NO textures/north.png
SO textures/south.png
DT textures/west.png

F 124, 40, 220
C 255, 80, 110

 
11111111111
10000W00001
11111111111
