NO ./textures/north.png
SO ./textures/south.png
WE ./textures/east.png
EA ./textures/west.png
	 
	
C                255,33,22
F 255,0,123

           0   1110
1111111111111111101111111111111111111111111
1001000000000000000000000000000000000000001
100D000000000000000000000000000000000011101
100100000000W000000000000000000000000010101
1001000000000000000000000000000000000011101
1001000000000000000000000000000000000000001
1111111111111111111111111111111111111111111
