NO ./textures/north.png
SO ./textures/south.png

WE ./textures/west.png
EA ./textures/east.png
C              230, 30, 50
F 255,0,123
111111111111111111111111111111111111
100000000000000000000000000000000001
11111111111100000111110000000000001
10000000000000000D000D000000000001
11111111111010111111110000000W0001
1000000000000000000000000000000001
1111111111111111111111111111111111
 
 111111
 100000
 111111
