WE textures/west.png
EA textures/east.png
NO textures/north.png
SO textures/south.png

F 124, 40, 220
C 255, 80, 110

111111111111111111111111111
100000000000000000000000001
1000000000000N0000000000111
1000000000000000000000001
 10000000000000000000011
  11111111100001111111
           1111
