WE textures/kiwi.jpg
EA textures/merguez.jpg
NO textures/patsek.jpg
SO textures/wd40.jpg
DT textures/door2.jpg

F 124, 40, 220
C 256, 80, 110

111111111111111111111
1N0000000011100000001
101111110011101111101
101000010000100000101
1D0111111101111101D11
10001000000000010001
10111111101111110101
10000000101000000101
10111110101011110101
1D0000010101000000D1
11110111011101111111
1D0000000000000000D1
111111111111111111111
